XXXXXXX
X     X
X --3 X
X     X
XXXXXXX
