XXXX XX
X <-  X
X | 3 X
X  -> X
XXXX XX
