XXX XXX
X  -  X
X - 3 X
X  -  X
XXX XXX
